1,1,1,1,1,1,1,1,1,1,1,1
1,0,0,0,5,5,3,3,3,3,3,1
1,0,0,0,5,4,3,4,3,3,3,1
1,0,0,0,0,3,3,3,3,3,3,1
1,0,0,0,0,4,0,3,3,3,3,1
1,0,3,0,0,4,3,3,4,2,2,1
1,0,0,0,0,4,2,2,2,2,2,1
1,0,0,0,0,4,2,2,4,2,2,1
1,0,4,0,5,5,2,2,2,2,2,1
1,0,0,0,5,5,2,2,2,2,2,1
1,0,0,0,5,5,2,4,2,2,2,1
1,1,1,1,1,1,1,1,1,1,1,1

1: 壁

0: 平地

2: 森

3: 草原

4: 聖なる泉

5: 砂地